The wind gently blows over you, sending a chill through your body. You stir. Silence. The wind blows again, slightly harder, enough to wake you. You come to and slowly get yourself off the ground. You look around, completely unfamiliar to all that surrounds you...
Thermolysis
An Interactive Fiction by Justin Tennant
Release 1 / Serial number 151223 / Inform 7 build 6L38 (I6/v6.33 lib 6/12N) SD

Railroad crossing
You stand next to a railway line which crosses a dirt road. The railroad runs from south to north; the dirt road east to west. There is a single wig-wag at the intersection.

>examine wig-wag
The tall iron crossing signal stands straight at the corner of the intersection, awaiting a train to come. A steel disc painted white with a red light at its center hangs from the top of the iron frame, serving as a pendulum. The red light is off, and the wig-wag is motionless.

>look
Railroad crossing
You stand next to a railway line which crosses a dirt road. The railroad runs from south to north; the dirt road east to west. There is a single wig-wag at the intersection.

>move east
You must name something more substantial.

>go east
Forest
You can see a match here.

>pick up match
Taken.

>inventory
You are carrying:
  a match

* * *

The wind gently blows over you, sending a chill through your body. You stir. Silence. The wind blows again, slightly harder, enough to wake you. You come to and slowly get yourself off the ground. You look around, completely unfamiliar to all that surrounds you...
Thermolysis
An Interactive Fiction by Justin Tennant
Release 1 / Serial number 151223 / Inform 7 build 6L38 (I6/v6.33 lib 6/12N) SD

Railroad crossing
You stand next to a railway line which crosses a dirt road. The railroad runs from south to north; the dirt road east to west. There is a single wig-wag at the intersection.

>east
Forest
Tall, motionless trees branch above and around you. You find a single stump amongst the dense and seemingly endless forest.

>examine stump
A lone stump sits amongst its living, taller counterparts. Its roots are thick and numerous, extending far beyond the other trees" roots reach. Countless rings circle round the top of the stump. Had the tree that once lived here not been felled, it would have easily been the oldest in the forest.

>take stump note
I only understood you as far as wanting to take the stump.

>take note
You can't see any such thing.

>look
Forest
Tall, motionless trees branch above and around you. You find a single stump amongst the dense and seemingly endless forest.

>examine
(the stump)
A lone stump sits amongst its living, taller counterparts. Its roots are thick and numerous, extending far beyond the other trees" roots reach. Countless rings circle round the top of the stump. Had the tree that once lived here not been felled, it would have easily been the oldest in the forest.

There appears to be a piece of paper folded and tucked into a sliver on the stump rings.

>examine the stump note
I only understood you as far as wanting to examine the stump.

>examine note stump
You can't see any such thing.

>examine notestump
You can't see any such thing.

>examine stumpnote
You can't see any such thing.

* * *

>examine stump
A lone stump sits amongst its living, taller counterparts. Its roots are thick and numerous, extending far beyond the other trees" roots reach. Countless rings circle round the top of the stump. Had the tree that once lived here not been felled, it would have easily been the oldest in the forest.

>take first note
You can't see any such thing.

>i
You are carrying nothing.

>t
That's not a verb I recognise.

>take
(the stump)
That's hardly portable.

>examine first note
You can't see any such thing.

>examine note
You can't see any such thing.

>open stump
It isn't something you can open.

* * *

>examine stump
A lone stump sits amongst its living, taller counterparts. Its roots are thick and numerous, extending far beyond the other trees" roots reach. Countless rings circle round the top of the stump. Had the tree that once lived here not been felled, it would have easily been the oldest in the forest.

>take paper
Taken.

>i
You are carrying:
  a first note

>read first note
You read: Never until the mankind making
 Bird beast and flower
 Fathering and all humbling darkness
 Tells with silence the last light breaking
 And the still hour
 Is come of the sea tumbling in harness

>examine first note
A palm-sized parchment neatly folded, and appears have writing on the inside. It was found tucked into the single stump in the forest.

* * *

>examine stump
A lone stump sits amongst its living, taller counterparts. Its roots are thick and numerous, extending far beyond the other trees" roots reach. Countless rings circle round the top of the stump. Had the tree that once lived here not been felled, it would have easily been the oldest in the forest.

>i
You are carrying nothing.

>e
You can't go that way.

>x
(the first note)
A palm-sized parchment neatly folded, and appears have writing on the inside. It was found tucked into the single stump in the forest.

>look
Forest
Tall, motionless trees branch above and around you. You find a single stump amongst the dense and seemingly endless forest.

You can see the first note here.

>take first nte
I only understood you as far as wanting to take the first note.

>take first note
Taken.

>read first note
As you unfold the parchment, a single match slips out into your hands.
Match added to your inventory.

You read: 
Never until the mankind making
 Bird beast and flower
 Fathering and all humbling darkness
 Tells with silence the last light breaking
 And the still hour
 Is come of the sea tumbling in harness

* * *

>examine stump
A lone stump sits amongst its living, taller counterparts. Its roots are thick and numerous, extending far beyond the other trees" roots reach. Countless rings circle round the top of the stump. Had the tree that once lived here not been felled, it would have easily been the oldest in the forest.

>x
(the first note)
A palm-sized parchment neatly folded, and appears have writing on the inside. It was found tucked into the single stump in the forest.

* * *

>examine stump
A lone stump sits amongst its living, taller counterparts. Its roots are thick and numerous, extending far beyond the other trees" roots reach. Countless rings circle round the top of the stump. Had the tree that once lived here not been felled, it would have easily been the oldest in the forest.

>look
Forest
Tall, motionless trees branch above and around you. You find a single stump amongst the dense and seemingly endless forest.

You can see the first note here.

>take note
Taken.

>read note
As you unfold the parchment, a single match slips out into your hands.

Match added to your inventory.

You read: 
Never until the mankind making
Bird beast and flower
Fathering and all humbling darkness
Tells with silence the last light breaking
And the still hour
Is come of the sea tumbling in harness

* * *

>east
Forest
Tall, motionless trees branch above and around you. You find a single stump amongst the dense and seemingly endless forest.

>look
Forest
Tall, motionless trees branch above and around you. You find a single stump amongst the dense and seemingly endless forest.

>look stump
A lone stump sits amongst its living, taller counterparts. Its roots are thick and numerous, extending far beyond the other trees" roots reach. Countless rings circle round the top of the stump. Had the tree that once lived here not been felled, it would have easily been the oldest in the forest.

There appears to be a piece of paper folded and tucked into a sliver on the stump rings.

>take piece of paper
Taken.

>inventory
You are carrying:
  a first note

>read first note
As you unfold the parchment, a single match slips out into your hands.

>i
You are carrying:
  a match
  a first note

>read first note
You read: Never until the mankind making
 Bird beast and flower
 Fathering and all humbling darkness
 Tells with silence the last light breaking
 And the still hour
 Is come of the sea tumbling in harness

>west
Railroad crossing
You stand next to a railway line which crosses a dirt road. The railroad runs from south to north; the dirt road east to west. There is a single wig-wag at the intersection.

>look west
You see the road continues to some destroyed buildings.

>go west
Ruins
You can see some unknown ruins and a ghost here.

>examine ghost
The ghost says nothing but hands you a lantern with a wick but no oil.

* * *

>look
Forest
Tall, motionless trees branch above and around you. You find a single stump amongst the dense and seemingly endless forest.

>examine stump
A lone stump sits amongst its living, taller counterparts. Its roots are thick and numerous, extending far beyond the other trees roots reach. Countless rings circle round the top of the stump. Had the tree that once lived here not been felled, it would have easily been the oldest in the forest.

>look
Forest
Tall, motionless trees branch above and around you. You find a single stump amongst the dense and seemingly endless forest.

>look
Forest
Tall, motionless trees branch above and around you. You find a single stump amongst the dense and seemingly endless forest.

* * *

>examine stump
A lone stump sits amongst its living, taller counterparts. Its roots are thick and numerous, extending far beyond the other trees roots reach. Countless rings circle round the top of the stump. Had the tree that once lived here not been felled, it would have easily been the oldest in the forest.

>take note
You can't see any such thing.

>west
Railroad crossing
You stand next to a railway line which crosses a dirt road. The railroad runs from south to north; the dirt road east to west. There is a single wig-wag at the intersection.

>west
Ruins
You can see some unknown ruins and a ghost here.

>talk to ghost
The ghost says nothing but hands you a lantern.
Lantern added to your inventory.

>east
Railroad crossing
You stand next to a railway line which crosses a dirt road. The railroad runs from south to north; the dirt road east to west. There is a single wig-wag at the intersection.

>east
Forest
Tall, motionless trees branch above and around you. You find a single stump amongst the dense and seemingly endless forest.

>examine stump
A lone stump sits amongst its living, taller counterparts. Its roots are thick and numerous, extending far beyond the other trees roots reach. Countless rings circle round the top of the stump. Had the tree that once lived here not been felled, it would have easily been the oldest in the forest.

There appears to be a piece of paper folded and tucked into a sliver on the stump rings.

>look
Forest
Tall, motionless trees branch above and around you. You find a single stump amongst the dense and seemingly endless forest.

You can see the first note here.

* * *

>read note
As you unfold the parchment, a single match slips out into your hands.

Match added to your inventory.

You read: 
Never until the mankind making
Bird beast and flower
Fathering and all humbling darkness
Tells with silence the last light breaking
And the still hour
Is come of the sea tumbling in harness

>move west
You must name something more substantial.

>move
What do you want to move?

>move west
You must name something more substantial.

>look west
You see the road continues to the railroad crossing.

>west
Railroad crossing
You stand next to a railway line which crosses a dirt road. The railroad runs from south to north; the dirt road east to west. There is a single wig-wag at the intersection.

* * *

>talk to ghost
The ghost says nothing but hands you a lantern.
Lantern added to your inventory.

>inventory
You are carrying:
  a lantern
  a match
  the first note

>talk to ghost
The ghost says nothing but hands you a lantern.
Lantern added to your inventory.

>talk to ghost
The ghost says nothing but hands you a lantern.
Lantern added to your inventory.

* * *

>inventory
You are carrying:
  a lantern
  a match
  the first note

>examine ghost
The ghost says nothing but hands you a lantern.
Lantern added to your inventory.

>look at ghost
The ghost says nothing but hands you a lantern.
Lantern added to your inventory.

* * *

>east
Forest
Tall, motionless trees branch above and around you. You find a single stump amongst the dense and seemingly endless forest.

>take note
You can't see any such thing.

>examine stump
A lone stump sits amongst its living, taller counterparts. Its roots are thick and numerous, extending far beyond the other trees" roots reach. Countless rings circle round the top of the stump. Had the tree that once lived here not been felled, it would have easily been the oldest in the forest.

There appears to be a piece of paper folded and tucked into a sliver on the stump rings.

>take paper
Taken.

>read paper
As you unfold the parchment, a single match slips out into your hands.
Match added to your inventory.

>read paper
You read: 
Never until the mankind making
 Bird beast and flower
 Fathering and all humbling darkness
 Tells with silence the last light breaking
 And the still hour
 Is come of the sea tumbling in harness

* * *

The wind gently blows over you, sending a chill through your body. You stir. Silence. The wind blows again, slightly harder, enough to wake you. You come to and slowly get yourself off the ground. You look around, completely unfamiliar to all that surrounds you...
Thermolysis
An Interactive Fiction by Justin Tennant
Release 1 / Serial number 151223 / Inform 7 build 6L38 (I6/v6.33 lib 6/12N) SD

Railroad crossing
You stand next to a railway line which crosses a dirt road. The railroad runs from south to north; the dirt road east to west. There is a single wig-wag at the intersection.

>west
Ruins
You can see some unknown ruins here.

>talk ghost
I didn't understand that sentence.

>talk to ghost
The ghost says nothing but hands you a lantern.
Lantern added to your inventory.

>speak to ghost
I didn't understand that sentence.

>speak ghost
(to the ghost)
There is no reply.

>examine ruins
Upon closer inspection, you see the pile of burnt, blackened wood used to be a farm house.

>l
Farm Ruins
You can see some farm house ruins and a ghost here.

>examine farm house ruins
A burnt and decrepit pile of wood planks that used to be a farm house.

>examine ghost
The ghost says nothing but hands you a lantern.

* * *

>talk to ghost
The ghost says nothing but hands you a lantern.
Lantern added to your inventory.

>lantern
That's not a verb I recognise.

>i
You are carrying:
  a lantern

>inspect lantern
That's not a verb I recognise.

>examine lantern
An old signal lantern made of metal. It has a rectangular body with a sizable and rotatable handle on top. 
It has a wick, but no oil seems to be inside.
The lantern is currently not lit.

The lantern is currently switched off.

>turn on lantern
You switch the lantern on.

* * *

>west
Ruins
You can see some unknown ruins here.

>examine ghost
The ghost says nothing but hands you a lantern.
Lantern added to your inventory.

>i
You are carrying:
  a lantern

>examine lantern
An old signal lantern made of metal. It has a rectangular body with a sizable and rotatable handle on top. 
 It has a wick, but no oil seems to be inside.

The lantern is currently switched off.

>turn on lantern
You switch the lantern on.